Level 1
'MICROCOSMOS 01'
#### ####
#  ###  #
# $ * $ #
#   +   #
### .$###
  # . #
  #####

Level 5
'MICROCOSMOS 05'
     ####
 #####  #
 # $ $  #
 #.# #. #
 # $@$ ##
##.# #.##
#  * *  #
#   #   #
#########

Level 6
'MICROCOSMOS 06'
 #####
 #   #
 # # ##
## *  ##
# $*$  #
#  * # #
## .  +#
 #######
